F 76,76,76
C 99,99,99

NO textures/simonkraft/cobblestone.xpm
SO textures/simonkraft/cobblestone_01.xpm
WE textures/simonkraft/mossy_cobblestone1.xpm
EA textures/simonkraft/cobblestone_02.xpm

111111111111111111111111
100000000100001000000001
100000000100001000000001
100000000111111111000001
10000000000N000001010001
100000000000000001000001
111111111111111111111111