NO textures/matrix.xpm
SO textures/matrix.xpm
WE textures/matrix.xpm
EA textures/matrix.xpm

F 139,99,58
C 171,154,137

111111111111111111111111
100000000100001000000001
100000000100001000000001
100000000111111110000001
10000000000000001010001
10000000000000N001000001
100000000000000001010001
100000000000000000000001
111111111111111111111111