NO textures/simonkraft/soul_sand.xpm
SO textures/simonkraft/soul_soil_01.xpm
WE textures/simonkraft/soul_soil.xpm
EA textures/simonkraft/soul_sand.xpm

C 53,41,34
F 45,33,27

111111111111111
111111000111111
111110000011111
11110000001111
111000000010111
1100000N0010011
100011111111001
110000111000011
111000010000111
111100000001111
111110000011111
111111000111111
111111111111111

